#####################
#                   #
#              #  E #
#              #    #
#   B          ######
#                   #
#                   #
#                   #
#                   #
#       #           #
#                   #
########D##         #
#         #         #
#         #         #
#         #         #
#         #         #
#         #   H     #
#   P     #         #
#         #         #
#         #         #
#####################
