#####################
#####################
#####################
###P########## H#####
### ##########  #####
### ##########  #####
### ##########  #####
### ##########  #####
### ##########  #####
### ##########  #####
#                 E #
#####################
#####################
#####################
#####################
#####################
#####################
#####################
#####################
#####################
#####################
